111111111111111111
1s0000000000000001
111111111111111101
100000000000000001
101111111111111101
100000000000000001
1000000000000000o1
111111111111111111